###                 #########
#   ###################   # #
# ####                # # # #
# ################### # # # #
#                     # # # #
#####################B# # # #
#   ##                # # # #
# # ## ### ## ######### # # #
# #    #   ####         # # #
# # ## ################ # # #
### ##             #### # # #
### ############## ## # # # #
###             ##    # # # #
###### ######## ####### # # #
###### ####             #   #
A      ######################
